x*ceo* | dddeo* | oxcdcd

*dd*e**d | doddocee | c*d*cdex | xe*edodd | doooexxe

cd** | *xcd | dooe | dede

cxx*odde | deedeece | ooececoe | odxd*o*d | eo*ce*ed | oddeo*do | ddxc*ddd | ecdoe*cd | d*ccodcc | do*dc*ed

deedo*cxo | dcocdecco | xccoododd

xod | edo | cde | xcc | eoo | o*d

edoed | cd*dd | d*xdo | doded | ddo*c | oe*ed | ceoox | d*ox*

*oxecd | eexoee | oecdo* | cecoxd | dddddx | dexcdd

eoec | eoce | dee* | cdoo | eccc

ooe | deo | eee | e** | dod | oeo | o**

ddddccee | deeexoo* | ceo*cceo | xxdedcce | o*oocxod | oecoeode | deooedco | occcoxdd | xooxooce

xocccodooo | ddccxxodoc | ooxcdxd*oc | cxde*eeecd | ododccd*ed | odooocxo*o | *excccce*x | exoccdodcc | odx*eedooe

dee*cdcdc | edeccddcx | **doxx**d | c*dxdcde* | eedooxced | *eddcoeod | ccexececc | coecexdec | od*dooooc

codx | decx

ceeoed | dooco* | edddxc | dceece | dcoee* | ooexed

odo*d | ce*ec | dxxoe | ocedx | eecex | deece

**** | *co* | *de* | ****

eoox | cecc | eoxd

ececo | xddxx | cod*c | deccd | ecocx | d*ox* | odde* | docoo | o*oxe | dc*xe

edocddcc | cdodcdec

xoooc | oddeo | xdecd | xdded | dexee | odcde

de | oc | cc | oe | xo | o* | cx | oo

odoeoecc* | dxeoxeoce | d*ec*code | xcxcxexxc | dcdooeoox | oocedcodc | oc*oooodd | ocxdee*de | *c*xeodco

oc | oo | e*

edo | eco | d*o | e*e | oxc | eoe | deo | eee

cxox | eoc* | cdcx | oecx | d*oo | edcc | od*x | c*ce | *occ | cc*d

eede** | xeeooc

xdocd | xodox | dxe*c

ecc | dex | edo | xdd | oex

eooed*o*ec | xdcooodo*d | xooed*dcod | ceooedcced | exoxcdeecc | dcdccxecdd

ccoe | cxc* | ooec | *dxc | dod* | xxeo | oxeo | eeo* | *xxx

edxdxecc | oexocee* | x*cxodex | oeeocxed | oceoooox | exx*eedc | od*od*cx | xccc**cd | ddoe*occ

ocdddocd | xdoodocx

de | ee | de | *o | oo | cc | de | oe

dxo | doe | deo

ceedoxxdx | xecodedoo | cddceddoe | doodxedoc | oeoeeoece

ceceed | dde*xx | ooddcd | edexed | xoco*e

co | ee | dx | cd | do | ec | ce | dx | oc

oecceoodo | xddxoxdxe | e*ccexoee

dd*edodxc | o*dxxdecc | oo*cdecde | xoxcecdee | edeoxdcee | co*deceo*